|----------------------------------\
|    **************************    |
|  **|*****|****|*|*|******|*|**   |
|**||***|****|*******|**|*****|*** |
|||*******|****|****|**|**|**|*****|
|0 *|*|*|****|***   *****|**|**|* 2|
|**|*|****|*****  1  *****|***|****|
|||*|*|**|*****|*****|*|***|****|*||
| *|***|****|*|*|*|******|****|*** |
| |*|****************************  |
|----------------------------------/