|----------------------------------\
|  0           ^ ^ ^^3^ ^^        *|
|  [][][]     ^  ^^ ^  ^ ^      **||
|  [][][]   o___________o     **||*|
|           |           |     ||***|
| o_________o     1     |    2  *|*|
|~|                     |     **|*||
|~|  4  o________/-\____o     ||*|*|
|~|H-H-H|~~~~|                 *|**|
|~~~~~~~~~~~~o                 |*|*|
|----------------------------------/